wwwwwwwwwwwwwwwwwwwwwwwwwwwwwwwwwwwwwwwwwwwwwwwwwwwwwwwwwwww
wrrrrrrrrrrrrrrrrrrrrrrrrrrrrr-----------------------------w
w----------------------------r-----------------------------w
w----------------------------r-----------------------------w
w----------------------------r-----------------------------w
w----------------------------r-----------------------------w
w----------------------------r-----------------------------w
w-------------------------gggr-----------------------------w
w----lllll----------------gggr-----------------------------w
w----llcll----------------gggr-----------------------------w
w----lllll----------------gggr-----------------------------w
w----------------------------r-----------------------------w
w----------------------------r-----------------------------w
w----------------------------r-----------------------------w
w----------------------------r-----------------------------w
w----------------------------r-----------------------------w
w----------------------------r-----------------------------w
w----------------------------r-----------------------------w
w----------------------------r-----------------------------w
w----------------------------r-----------------------------w
w----------------------------r-----------------------------w
w----------------------------r-----------------------------w
w----------------------------r-----------------------------w
w----------------------------r-----------------------------w
w----------------------------r-----------------------------w
w----------------------------r-----------------------------w
w----------------------------r-----------------------------w
w----------------------------r-----------------------------w
w----------------------------r-----------------------------w
w----------------------------r-----------------------------w
w----------------------------r-----------------------------w
w----------------------------r-----------------------------w
w----------------------------r-----------------------------w
w----------------------------r-----------------------------w
w----------------------------r-----------------------------w
w----------------------------r-----------------------------w
w----------------------------r-----------------------------w
w----------------------------r-----------------------------w
w----------------------------r-----------------------------w
w----------------------------r-----------------------------w
w----------------------------r-----------------------------w
w----------------------------r-----------------------------w
w----------------------------r-----------------------------w
w----------------------------r-----------------------------w
w----------------------------r-----------------------------w
w----------------------------r-----------------------------w
w----------------------------r-----------------------------w
w----------------------------r-----------------------------w
w----------------------------r-----------------------------w
w----------------------------r-----------------------------w
w------------rrrrrrrrrrrrrrrrrrrrrrrrrrrrrrrrrrrr----------w
w-------------------------r--r----r------------------------w
w-----------------------T-rTtr-tT-rT-----------------------w
w-------------------------r--r----r------------------------w
w-------------------------r--r----r------------------------w
w-----------------------T-rTtr-tT-rT-----------------------w
w-------------------------r--r----r------------------------w
w-------------------------r--r----r------------------------w
wwwwwwwwwwwwwwwwwwwwwwwww5134532341wwwwwwwwwwwwwwwwwwwwwwwww
