wwwwwwwwwww43212344321234wwwwwwwwwwwwwwwwwwwwwwwwwwwwwwwwwwwwwwwwwwwwwwwwwwwww
w-------------r------r---------------------------r---------------------------w
w-------------r------r---------------------------r---------------------------w
w-------------r------r---------------------------r----------TTTTTTTTTT-------w
w-------------r------r---------------------------r----------TTTTTTTTTT-------w
w-------------r------r---------------------------r----------TTTTTTTTTT-------w
w-------------r------r---------------------------r---------------------------w
wrrrrrrrrrrrrrrrrrrrrrrrrrrrrrrrrrrrrrrrrrrrrrrrrr---------------------------w
w-------------r------r---------------------------r---------------------------w
w-------------r------r---------------------------r---------------------------w
w-------------r------r----------TTTTTTT----------rrrrrrrrrrrrrrrrrrrrrrrrrrrrw
w-------------r------r----------TTTTTTT----------r---------------------------w
w-------------r------r---------------------------r---------------------------4
w---tt--------r------r---------------------------r---------------------------3
w---tt--------r------r---------------------------r---------------------------2
w---tt--------r------rrrrrrrrrrrrrrrrrrrrrrrrrrrrrrrrrrrrrrrrrrrrrrrrrrrrrrrr1
w-------------r------r---------------------------r---------------r-----------2
w-------------r------r---------------------------r---------------r-----------3
w-------------r------r---------------------------r---------------r-----------4
w-------------r------r---------------------------r---------------r-----------w
w-------------r------r---------------------------r---------------r-----------w
wrrrrrrrrrrrrrrrrrrrrr---------------------------r---------------r-----------w
w-------------r------r---------------------------r---------------r-----------w
w-------------r------r---------------------------r---------------r-----------w
w-------------r------r---------------------------r---------------r-----------w
w-------------r------r---------------------------r---------------r-----------w
w-------------r------r---------------------------r---------------r-----------w
w-------------r------r---------------------------r---------------r-----------w
w-------------rrrrrrrrrrrrrrrrrrrrrrrrrrrrrrrrrrrrrrrrrrrrrrrrrrrr-----------w
w-------------r------r---------------------------r---------------------------w
w-------------r------r---------------------------r---------------------------w
w-------------r------r---------------------------r---------------------------w
w-------------r------r---------------------------r---------------------------w
w-------------r------r---------------------------r---------------------------w
wwwwwwwwwwwwwwwwwwwwwwwwwwwwwwwwwwwwwwwwwww4433221223344wwwwwwwwwwwwwwwwwwwwww
